1900_Galveston_hurricane	NS
1906_Intercalated_Games	EL
1981_South_Africa_rugby_union_tour_of_New_Zealand	EL
Abbasid_Caliphate	PR,H
Abu_Dhabi	G
Alan_Jones_(racing_driver)	Bio,EL
Alexios_V_Doukas	Bio
Anatoliy_Tymoshchuk	Bio
Ancestor_worship	PR
Andy_Murray	Bio
Anne_Hathaway	Bio
Anwar_Ibrahim_(politician)	Bio
Arab_World	G
Austria–Hungary	G
Basque_Country_(greater_region)	G
Battle_of_the_Catalaunian_Plains	H
Black_Francis	Bio, Arts
Bumiputera_(Malaysia)	G,SSS
Cabinda_Province	G
Cantonese	LL
Catch_Me_If_You_Can	Arts
Cécilia_Attias	Bio
Cesar_Department	G
Chadian–Libyan_conflict	H
Charles_de_Gaulle_International_Airport	G
Chartres_Cathedral	G
Chris_Brown_(entertainer)	Bio
City_and_South_London_Railway	G
Cole_&_Dylan_Sprouse	Bio
Community_of_Madrid	G
Congee	EL
Council_of_Florence	H
Creek_(people)	SSS
Dari_(Eastern_Persian)	LL
Days_of_Our_Lives	Arts
De_La_Salle_University	EL
Dick_Durbin	Bio
Dmitry_Donskoy	Bio
Domestic_water_buffalo	NS
East_London_Line	G
Eli_Whitney,_Jr.	Bio
Empress_Matilda	Bio
Ermine	NS
Eros	PR
European_Badger	NS
European_Otter	NS
Fatimid_Caliphate	PR,H
FC_Zenit_St._Petersburg	EL
First_Jewish–Roman_War	H
Five-Year_Plans_for_the_National_Economy_of_the_Soviet_Union	H
Gallipoli_Campaign	H
Gilbert_du_Motier,_marquis_de_Lafayette
Giovani_Dos_Santos	Bio
Go_(game)	EL
Golden_Raspberry_Award	Arts
Government_of_Egypt	SSS
Grande_Armée	H
Greco–Persian_Wars	H
Grigory_Potyomkin	Bio
Gustaf_VI_Adolf_of_Sweden	Bio
Halong_Bay	G
Harbor_Seal	NS
Haumea_(dwarf_planet)	NS
Henry_(Bishop_of_Uppsala)	Bio
Henry_the_Fowler	Bio
Hernando_de_Soto	Bio
Hewlett-Packard	EL
Hideki_Tōjō	Bio
History_of_Colonial_Hong_Kong_(1800s–1930s)	H
History_of_the_Arab–Israeli_conflict	H
History_of_the_Luftwaffe_1933_-_1945	H
Iamblichus	Bio
Indonesia–Malaysia_confrontation	H
International_reaction_to_the_2008_declaration_of_independence_by_Kosovo	SSS
Iran–Iraq_War	H
Israeli–Palestinian_conflict	H
Israeli_Premier_League	EL
James_Abbott_McNeill_Whistler	Bio
John_Cabell_Breckinridge	Bio
John_Dee	Bio
J._Robert_Oppenheimer	Bio
Judaeo-Spanish	LL
Konstantin_Eduardovich_Tsiolkovskii	Bio
La_dolce_vita	Arts
Lahaul_and_Spiti	G
Lancelot_“Capability”_Brown	Bio
Languages_of_India	LL
List_of_Assyrian_kings	H
List_of_Portuguese_royal_consorts	H
Llŷn_Peninsula	G
Lomonosov_Moscow_State_University	EL
Magdalena_Department	G
Mandarin_Chinese	LL
Married..._with_Children	Arts
Mason-Dixon_Line	H,G
Matera	G
Mercedes-Benz_Arena	G
Mexican–American_War	H
Min_Nan	LL
Mohammed_Reza_Pahlavi	Bio
Molotov–Ribbentrop_Pact	H
Muhammad_ibn_Zakariya_ar-Razi	Bio
Nicole_Vaidišová	Bio
Noise_(music)	Arts
Nyx	EL
Ojibwa-Potawatomi-Ottawa_language	LL
Oklahoma_City_Thunder	EL
Ons_Heemecht	Arts
Pahlavi_dynasty	H
People's_Republic_of_China–United_States_relations	H
Pergamum	G
Persian_people	G
Pharrell	Bio,Arts
Philippine–American_War	H
Philippines_men's_national_basketball_team	EL
Polish–Lithuanian–Teutonic_War	H
Polish–Muscovite_War_(1605–1618)	H
Polish–Soviet_War	H
Polish–Ukrainian_War	H
Political_divisions_of_Mexico	SSS
Port_Coquitlam	G
Puducherry	G
Rashidun_Caliphate	PR,H
Renaissance_Center	G
Romanos_IV_Diogenes	Bio
Saṃsāra	PR
Scanian_dialects	LL
Seinen_manga	Arts
September_11_attacks	H
Shinzō_Abe	Bio
Siemens	SSS
Seattle	G
Simplified_Chinese_characters	LL
Skid_Row_(U.S._band)	Arts
Somaliland	G
Southern_Pacific_Transportation_Company	AST
Spanish–American_War	H
Steve_Borden	Bio
Sultanate_of_Rûm	H,G
Süper_Lig	EL
Swedish_cuisine	EL
Tainan_City	G
Taiwanese	LL
Taraxacum	NS
Teochew_dialect	LL
Thai_cuisine	EL
The_Wire	Arts
Traditional_Chinese_characters	LL
Ulm_Cathedral	G
Umayyad_Caliphate	PR,H,G
University_of_Montréal	EL
Valle_del_Cauca_Department	G
Võ_Nguyên_Giáp	Bio
Wampanoag	SSS
Wars_and_conflicts_between_India_and_Pakistan	H
Westfalenstadion	G
West_Vancouver	G
Wu_Chinese	LL
Xanadu_Houses	G
